111111111111111111111111111111
100000000000000C10000001C00001
10100101101000111010010111E101
1C1011001C10101000100100010101
101000111110100000100000000001
100000100000111100001000011111
1P10001C10001C00000010000000C1
111111111111111111111111111111