111111111111111111111111111111
1M000000000000MC1000M001C00001
10100101101000111010010111E101
1C1011001C10101000100100010101
1010001111101000001000000000M1
1000M010000M1111000M1000M11111
1P10001C10001C00000010000000C1
111111111111111111111111111111